11111111111111
1C1C1001P01CC1
10000000100001
10111110001111
1000C1C01000C1
11110E11111111
11111111111111
