111111111111111111111111
1010000000000000000000C1
100011111111111111111111
10001000001P000000000001
111000100100010111010001
10000110010001E111000011
100000000000010100000001
111111111110000001111111
